%%%%%%%%%%%%%%%
%     %   %   %
%%       %%   %
%% %  % %   %%%
%% %%%%    P%%%
% %    % % % %%
%%  %% . %%   %
% % %% %      %
%  %    %  %  %
%    %        %
%%    %     %%%
%% %   %%%    %
%        %    %
% %  %     %% %
%%%%%%%%%%%%%%%
